#############################
#.............#.............#
#.............#.............#
#..###..####..#..####..###..#
#..###..####..#..####..###..#
#...........................#
#...........................#
#..###..#..#######..#..###..#
#.......#.....#.....#.......#
#.......#.....#.....#.......#
######..####..#..####..######
######..#...........#..######
######..#...........#..######
######..#..###.###..#..######
...........#.....#...........
...........#.....#...........
######..#..#######..#..######
######..#...........#..######
######..#...........#..######
######..#..#######..#..######
#.............#.............#
#.............#.............#
#..###..####..#..####..###..#
#....#.................#....#
#....#.................#....#
###..#..#..#######..#..#..###
#.......#.....#.....#.......#
#.......#.....#.....#.......#
#..#########..#..#########..#
#...........................#
#...........................#
#############################
